O esporte = The sport
O futebol = The soccer / football
O basquete = The basketball
O tênis = The tennis
O vôlei = The volleyball
O beisebol = The baseball
O golfe = The golf
O rugby = The rugby
O críquete = The cricket
O ciclismo = The cycling
A natação = The swimming
A corrida = The running / race
O atletismo = The athletics
O boxe = The boxing
O judô = The judo
O karatê = The karate
O surfe = The surfing
O skate = The skateboarding
O esqui = The skiing
O snowboard = The snowboarding
O mergulho = The diving
O salto em altura = The high jump
O salto em distância = The long jump
O salto com vara = The pole vault
O lançamento de peso = The shot put
O arco e flecha = The archery
O hóquei = The hockey
O polo aquático = The water polo
O handebol = The handball
O levantamento de peso = The weightlifting
O triatlo = The triathlon
O pentatlo moderno = The modern pentathlon
O esporte radical = The extreme sport
O paraquedismo = The skydiving
O pára-quedas = The parachute
O automobilismo = The motorsport
O voo livre = The hang gliding
O bungee jumping = The bungee jumping
O boliche = The bowling
O polo = The polo
O tiro com arco = The archery
O remo = The rowing
O patinação = The skating
O alpinismo = The mountaineering
O mergulho livre = The free diving
O motocross = The motocross
O paraquedas ascensional = The paragliding
O esporte aquático = The water sport
O slackline = The slacklining
O bobsled = The bobsled