Pendurar = to hang
Descobrir = to discover
Procurar = to search
Fofocar = to gossip
Levantar = to lift up, to get up
Deitar = to lie down
Descer = to go down
Subir = to go up
Pedir = to order/ask
Mandar = to send/order
Ouvir = to hear
Escutar = to listen
Importar = to care, to import, to matter 
Saborear = to taste, to savour
Praticar = to practice
Tocar = to touch, to play an instrument, to ring 
Respeitar = to respect
Levar = to take
Trazer = to bring
Achar = to find/think
Dobrar = to fold/double/bend
Embrulhar = to wrap 
Significar = to mean 
Trair = to betray, to cheat
Vencer = to win, to expire 
Perder = to lose
Desenhar = to draw
Apagar = to delete/pass out/put out/turn off
Desmaiar = to faint, to pass out
Bater = to hit, to knock 
Lavar = to wash
Secar = to dry
Molhar = to make it wet
Temperar = to put spices on something
Arranhar = to scratch
Puxar = to pull
Empurrar = to push
Escovar = to brush
Arrepender = to regret
Revelar = to reveal
Contar = to count 
Cheirar = to smell
Esquecer = to forget
Confiar = to trust
Conferir = to check
Enviar = to send 
Receber = to receive
Voar = to fly
Nadar = to swim
Vomitar = to throw up
Amarrar = to tie up
Tirar = to take out/off
Atirar = to shoot 
Disparar = to shoot
Arrastar = to drag
Pular = to jump
Suar = to sweat
Soar = to ring
Surgir = to appear/emerge/arise
Rechear = to fill/stuff
Temer = to fear (formal)
Acender = to turn/light on
Rasgar = to tear apart, to rip
Furar = to make a hole
Mastigar = to chew 
Cochilar = to nap
Roncar = to snore 
Magoar  = to hurt/upset someone (formal)
Chatear = to upset 
Guardar = to put away 
Relembrar = to remember again
Lembrar = to remember 
Estender = to unfold, to set out, to extend
Esticar = to stretch 
Machucar = to hurt 
Fumar = to smoke
Aspirar = to aspirate/inhale
Cuspir = to spit
Engolir = to swallow
Espirrar = to sneeze
Medir = to measure
Costurar = to sew
Esquentar = to warm up
Aquecer = to heat up
Esfriar = to cool down
Resfriar = to cool down/freeze 
Girar = to rotate 
Descascar = to peel
Dever = should, must, duty, to owe
Apertar = to squeeze, to press, to tighten
Cortar = to cut 
Tremer = to tremble/shake
Sentir = to feel
Gostar = to like
Decorar = to decorate/memorize
Miar = to meow
Latir = to bark
Arrotar = to burp
Morder = to bite
Lamber = to lick
Decidir = to decide
Dividir = to divide
Desistir = to give up
Derrubar = to drop
Derramar = to spill
Reclamar = to complain
Botar = to put
PÃ´r = to put 
Destruir = to destroy
Identificar = to identify
Embaralhar = to shuffle 
Derreter = to melt
Esmagar = to smash/crush
Escorrer = to drain/flow (liquid)
Gotejar = to drip
Decepcionar = to let down/to disappoint
exercitar = to exercise (yourself)
Embalar = to pack
Xingar = to curse 
Jurar = to swear
Assar = to bake
Fritar = to fry
vestir = to dress
sentir = to feel
Queixar = to complain (formal)
Adicionar = to add
Juntar = to add/gather
Resolver = to solve
Sumir = to disappear
Desaparecer= to disappear
Realizar = to perform, to carry out (formal way)
Perceber = to notice, to realize
Esconder = to hide 
Martelar = hammering
Desconfiar = to mistrust
Aumentar = to increase
Diminuir = to decrease
Pisar = to step on 
Alagar = to flood
Incendiar = to set fire (formal)
Aguentar = to endure/bear
Adiantar = to advance/be of use 
Medicar = to medicate
Tratar = to treat
Desmoronar = to collapse
Desmembrar = to dismember
Demolir = to break down
Assoviar = to whistle 
Digitar = to type 
Incomodar = to bother
Revisar = to review
Boiar = to float
Cobrar = to demand, to charge
Fingir = to pretend 
Montar = to put together
Desmontar = to unput 
Rezar = to pray
Sorrir = to smile
Amassar = to crease/mash
Inventar = to invent
Investir = to invest
Emprestar = to borrow
Salvar = to save 
Depositar = to deposit
Nascer = to be born
Mexer = to move, to stir, to work with something, to tease someone
Receber = to receive 
Reparar = to notice, to repair 
Estourar = to burst 
Apoiar = to support
Aprovar = to aprove 
Seguir = to follow
Anotar = to write down, to annotate
Ralar = to grate 
Escorregar = to slip, to fall down